##########
#b  X   X#
#        #
#   C    #
# P      #
#      #C#
#  C  p# #
#    pO# #
#  X  p#E#
##########
